20 20
####################
#      K           #
#  ############## ##
#    A      # K # ##
########### #AK #A##
#    S K    #   # L#
# ############D#####
#      #      A    #
#   A  #     S     #
#                  #
########D###########
#        A         #
# # ########### #K #
# #K   #   A  # ####
# # #A # #### #   ##
# # #### #  # ### ##
# #   E# #K        #
# #D#### ###########
#       S          #
####################